60
20
58 19 19 19 19 19 19 19 19 19 62 63 63 63 64 19 19 19 19 19 19 19 19 19 26 26 26 26 26 26 26 26 26 26 17 1 1 0 1 1 23 23 23 23 23 23 23 23 23 23 23 23 23 23 47 15 15 15 15 15 
58 19 19 19 19 19 19 19 19 19 19 11 12 13 19 19 19 19 19 19 19 19 19 26 26 26 26 26 26 26 26 26 26 17 17 1 14 14 14 1 23 23 23 23 23 23 23 23 23 23 23 23 23 23 47 15 15 15 15 15 
58 19 19 19 19 19 19 19 19 19 19 19 9 19 19 19 19 19 19 19 19 19 26 18 26 26 26 26 17 17 17 17 29 17 17 1 14 14 14 1 23 23 23 23 23 23 23 23 23 23 23 23 23 23 47 15 15 15 15 15 
58 19 19 19 19 19 19 19 19 19 19 19 7 19 19 19 19 19 19 19 19 19 19 18 18 26 66 67 67 68 17 26 29 17 19 1 14 14 14 1 23 23 23 23 23 23 23 23 23 23 23 23 23 23 47 15 15 15 15 15 
58 19 19 19 19 19 19 19 19 19 19 19 6 19 19 19 19 19 19 19 19 19 19 17 17 17 17 17 17 17 17 17 17 17 17 1 14 14 14 1 23 23 23 23 23 23 23 23 23 23 23 23 23 23 47 15 15 15 15 15 
58 19 19 19 19 19 19 19 19 19 19 19 5 19 19 19 19 19 19 19 19 19 17 69 70 71 17 17 17 17 25 25 17 17 17 62 63 63 63 64 24 24 24 24 24 24 23 23 23 23 23 23 23 23 15 15 15 15 15 15 
58 19 19 19 19 19 19 19 19 19 19 2 3 4 19 19 19 19 19 19 19 19 19 17 17 17 20 20 20 20 26 26 17 17 19 19 11 12 13 17 24 24 24 23 23 23 23 23 23 23 23 23 23 23 15 15 15 15 15 15 
14 54 54 54 55 20 20 20 20 20 53 54 54 54 55 17 17 17 17 17 56 54 58 17 17 17 17 17 17 17 17 17 17 17 17 17 17 9 17 17 17 17 17 17 17 53 54 54 55 70 70 70 70 70 44 45 45 45 45 45 
14 14 14 14 58 53 54 54 54 55 56 14 14 14 58 19 19 19 19 19 56 14 58 17 17 17 17 17 17 19 22 22 17 17 22 18 22 7 19 23 23 23 23 23 23 56 14 14 58 21 23 23 23 23 47 15 15 15 15 15 
14 14 14 14 58 56 57 57 57 58 56 14 14 14 58 19 19 19 17 17 56 14 58 17 17 17 17 17 17 17 19 19 19 17 19 19 19 6 19 23 23 23 23 23 23 56 14 14 58 23 23 23 23 23 47 15 15 15 15 15 
60 60 60 60 61 56 57 57 57 58 56 14 14 14 58 19 19 19 19 19 56 14 58 17 17 17 17 17 17 19 19 19 19 17 19 19 19 5 19 23 23 23 23 23 23 59 60 60 61 23 23 23 23 23 47 15 15 15 15 15 
19 19 19 19 19 59 60 60 60 61 59 60 60 60 61 19 19 19 19 19 59 60 61 19 19 19 19 19 19 19 19 19 19 17 19 19 2 3 4 19 19 19 19 19 19 19 19 19 19 19 19 19 19 19 47 15 15 15 15 15 
19 19 19 19 19 19 19 19 19 19 19 19 19 19 19 19 19 19 19 19 19 19 19 19 19 19 19 19 19 19 19 19 19 17 19 19 19 19 19 19 19 19 19 19 19 23 23 23 23 23 23 23 23 23 47 15 15 15 15 15 
19 19 19 19 19 19 19 19 19 19 19 19 19 19 19 19 19 19 19 19 19 19 19 19 19 19 19 19 19 19 19 19 19 19 19 19 19 19 19 19 19 23 19 19 23 23 23 23 23 23 23 23 23 23 50 51 51 51 51 51 
19 19 19 19 19 19 19 19 19 19 19 19 19 19 19 19 19 19 19 19 19 19 19 19 19 19 19 19 19 19 19 19 19 19 19 19 19 19 19 19 23 23 23 23 23 23 23 23 23 23 23 23 23 23 23 23 23 23 23 23 
19 19 19 19 19 19 19 19 19 19 19 19 19 19 19 19 19 19 19 19 19 19 19 19 19 19 19 19 19 19 19 19 19 19 19 19 19 19 19 19 23 23 23 23 23 23 23 23 23 23 23 23 23 23 23 23 23 23 23 23 
19 19 19 19 19 19 19 19 19 19 19 22 22 22 19 19 19 19 19 19 19 19 19 19 19 19 19 19 19 19 19 19 19 19 19 19 19 19 19 19 23 23 23 23 23 23 23 23 23 23 23 23 23 23 23 23 23 23 23 23 
19 19 19 19 19 19 19 19 19 19 19 22 22 22 22 22 22 19 19 19 19 19 19 19 19 19 19 19 19 19 19 19 19 19 19 19 19 23 23 23 23 23 23 23 23 23 23 23 23 23 23 23 23 23 23 23 23 23 23 23 
19 19 19 19 19 19 19 19 19 22 22 22 22 22 22 22 22 22 22 22 19 19 19 19 19 19 19 19 19 19 19 19 19 19 19 23 23 23 23 23 23 23 23 23 23 23 23 23 23 23 23 23 23 23 23 23 23 23 23 23 
19 19 19 19 19 19 19 19 19 19 19 19 19 19 19 19 19 19 19 22 22 19 19 19 19 19 19 19 19 19 19 19 19 19 19 19 23 23 23 23 23 23 23 23 23 23 23 23 23 23 23 23 23 23 23 23 23 23 23 23 
