60
20
65 51 51 51 51 51 51 51 51 51 51 51 51 51 51 51 51 51 51 51 51 51 51 51 51 51 51 51 51 51 51 51 51 51 51 51 51 51 51 51 51 51 51 51 51 51 51 51 51 51 51 51 51 51 51 51 51 51 51 16 
49 19 19 19 19 19 17 19 17 17 15 15 15 15 15 17 19 19 19 19 15 15 15 26 26 26 26 26 26 17 17 17 26 17 17 15 15 15 15 15 23 23 17 17 17 17 17 17 17 17 17 23 23 23 15 15 15 15 15 49 
49 19 19 19 19 19 19 19 17 17 15 15 15 15 15 17 17 19 19 19 15 15 15 17 17 17 17 17 17 17 17 17 17 17 17 15 15 15 15 15 23 23 23 23 17 17 17 17 17 17 17 17 23 23 15 15 15 15 15 49 
49 19 19 17 19 19 19 19 19 17 15 15 15 15 15 17 19 17 19 19 15 15 15 17 17 17 17 17 17 17 17 17 29 17 19 15 15 15 15 15 23 23 23 23 17 17 17 17 17 17 17 17 23 23 15 15 15 15 15 49 
49 19 19 19 19 19 19 19 19 17 15 15 15 15 15 19 19 19 19 19 15 15 15 17 17 17 17 17 17 17 17 17 17 17 17 15 15 15 15 15 23 23 23 23 17 17 17 17 17 17 23 23 23 23 15 15 15 15 15 49 
49 19 19 19 19 19 19 19 17 17 15 15 15 15 15 19 19 19 19 19 15 15 15 17 17 17 69 70 70 70 71 25 17 17 17 44 45 45 45 46 17 17 17 17 17 17 17 17 17 17 23 23 23 23 15 15 15 15 15 49 
49 19 19 19 19 19 19 19 19 17 15 15 15 15 15 19 19 19 44 46 15 15 15 44 46 17 20 20 20 20 26 26 17 17 19 50 51 51 51 52 24 24 24 23 23 44 45 45 45 45 45 45 45 46 15 15 15 15 15 49 
65 45 45 45 46 20 20 20 20 20 44 45 45 45 46 17 17 17 47 49 44 45 46 47 49 17 17 17 17 17 17 17 17 17 17 17 17 17 17 17 17 17 17 17 18 47 15 15 15 15 15 15 15 49 44 45 45 45 45 16 
15 15 15 15 49 44 45 45 45 46 47 15 15 15 49 19 19 19 47 49 47 15 49 47 49 17 17 17 17 19 22 22 17 17 22 17 22 17 17 23 23 23 23 23 18 47 15 15 15 15 15 15 15 49 47 15 15 15 15 15 
15 15 15 15 49 47 15 15 15 49 47 15 15 15 49 19 19 19 47 49 47 15 49 47 49 17 17 17 17 17 17 17 19 17 19 17 17 17 17 23 23 23 23 23 18 47 15 15 15 15 15 15 15 49 47 15 15 15 15 15 
51 51 51 51 52 47 15 15 15 49 47 15 15 15 49 19 19 19 47 49 47 15 49 47 49 17 17 17 17 19 19 17 17 17 19 17 17 17 17 23 23 23 23 23 23 47 15 15 15 15 15 15 15 49 47 15 15 15 15 15 
19 19 19 19 19 50 51 51 51 52 50 51 51 51 52 19 19 19 50 52 50 51 52 50 52 19 19 19 19 19 19 17 17 17 17 17 17 17 17 19 19 19 19 19 19 47 15 15 15 15 15 15 15 49 47 15 15 15 15 15 
19 19 19 19 19 19 19 19 19 19 19 19 19 19 19 19 19 19 19 19 19 19 19 19 19 19 19 19 19 19 19 19 19 17 17 17 17 19 19 19 19 19 19 19 19 47 15 15 15 15 15 15 15 49 47 15 15 15 15 15 
19 19 19 19 19 19 19 19 19 19 19 19 19 19 19 19 19 19 19 19 19 19 19 19 19 19 19 19 19 19 19 19 19 19 19 19 19 19 19 19 19 23 19 19 17 50 51 51 51 51 51 51 51 52 50 51 51 51 51 51 
19 19 19 19 19 19 19 19 19 19 19 19 19 19 19 19 19 19 19 19 19 19 19 19 19 19 19 19 19 19 19 19 19 19 19 19 19 19 19 19 23 23 23 23 23 23 23 23 23 23 23 23 23 23 23 23 23 23 23 23 
19 19 19 19 19 19 19 19 19 19 19 19 19 19 19 19 19 19 19 19 19 19 19 19 19 19 19 19 19 19 19 19 19 19 19 19 19 19 19 19 23 23 23 23 23 23 23 23 23 23 23 23 23 23 23 23 23 23 23 23 
19 19 19 19 19 19 19 19 19 19 19 22 22 22 19 19 19 19 19 19 19 19 19 19 19 19 19 19 19 19 19 19 19 19 19 19 19 19 19 19 23 23 23 23 23 23 23 23 23 23 23 23 23 23 23 23 23 23 23 23 
19 19 19 19 19 19 19 19 19 19 19 22 22 22 22 22 22 19 19 19 19 19 19 19 19 19 19 19 19 19 19 19 19 19 19 19 19 23 23 23 23 23 23 23 23 23 23 23 23 23 23 23 23 23 23 23 23 23 23 23 
19 19 19 19 19 19 19 19 19 22 22 22 22 22 22 22 22 22 22 22 19 19 19 19 19 19 19 19 19 19 19 19 19 19 19 23 23 23 23 23 23 23 23 23 23 23 23 23 23 23 23 23 23 23 23 23 23 23 23 23 
19 19 19 19 19 19 19 19 19 19 19 19 19 19 19 19 19 19 19 22 22 19 19 19 19 19 19 19 19 19 19 19 19 19 19 19 23 23 23 23 23 23 23 23 23 23 23 23 23 23 23 23 23 23 23 23 23 23 23 23 
